tote bags	[bags_sign]
duffle & top handle bags	[bags_sign]
backpacks	[bags_sign]
messenger bags & satchels	[bags_sign]
ties	[accessories_sign]
tops	[tops_sign]
shirts	[tops_sign]
fine jewelry	[accessories_sign]
sandals	[shoes_sign]
clutches & pouches	[bags_sign]
monkstraps	[shoes_sign]
lace ups	[shoes_sign]
eyewear	[accessories_sign]
pouches & document holders	[bags_sign]
pants	[pants_sign]
suits & blazers	[dresses_sign]
travel bags	[bags_sign]
hats	[accessories_sign]
belts & suspenders	[accessories_sign]
keychains	[accessories_sign]
shoulder bags	[bags_sign]
blankets	[accessories_sign]
lingerie	[others_sign]
underwear & loungewear	[others_sign]
jewelry	[accessories_sign]
skirts	[skirts_sign]
flats	[shoes_sign]
briefcases	[bags_sign]
duffle bags	[bags_sign]
pocket squares & tie bars	[accessories_sign]
jackets & coats	[coats_sign]
swimwear	[others_sign]
scarves	[accessories_sign]
boots	[shoes_sign]
boat shoes & moccasins	[shoes_sign]
messenger bags	[bags_sign]
gloves	[accessories_sign]
socks	[accessories_sign]
espadrilles	[shoes_sign]
bag accessories	[accessories_sign]
heels	[shoes_sign]
loafers	[shoes_sign]
sweaters	[tops_sign]
jumpsuits	[dresses_sign]
sneakers	[shoes_sign]
jeans	[pants_sign]
shorts	[pants_sign]
dresses	[dresses_sign]
